pharmacy=farmacia
auction=aste
accounting=contabilità
politics=politica
arithmetic=aritmetica
war industry=industria bellica
e-commerce=e-commerce
psychology=psicologia
public and administrative law=diritto pubblico e amministrativo
enology=enologia
Judaism=ebraismo
enigmatography=enigmistica
thermodynamics=termodinamica
glass painting=pittura vetraria
interior decoration=arredamento
gambling game=gioco d'azzardo
worship=religione
evolution=evoluzione
volcanology=vulcanologia
hospital=ospedale
masonry=muratura
scientific terms=termini scientifici
mathematics=matematica
drawing=disegno
commerce=commercio
oil=petrolio
ancient history=storia antica
aviation=aviazione
fencing=scherma
programming=programmazione
rhetoric=retorica
watch making=orologeria
textile industry=industria tessile
cosmetics industry=industria cosmetica
zootechnics=zootecnia
painting=pittura
contemporary history=storia contemporanea
Buddhism=buddismo
needlework=lavori di cucito
seismology=sismologia
sexology=sessuologia
public finance=finanza pubblica
graphic arts=arti grafiche
computer art=computer art
oncology=oncologia
ethnology=etnologia
history=storia
table tennis=ping-pong
private finance=finanza privata
slaughtering=macellazione
chemistry=chimica
ballet=balletto-danza
parachuting=paracadutismo
libraries=biblioteche
unions=sindacati
carpentry=falegnameria
psychiatry=psichiatria
architecture=architettura
gastronomy=gastronomia
surgery=chirurgia
paleontology=paleontologia
footwear industry=industria calzaturiera
chemical industry=industria chimica
software=software
ornithology=ornitologia
thermohydraulics=termo-idraulica
mythology=mitologia
composition=composizione
mountaineering=alpinismo
bank=banca
homeopathy=omeopatia
decoupage=decoupage
monitor=monitor
trekking=trekking
metallurgy=metallurgia
building industry=edilizia
fleet=marina
touristic facilities=strutture turistiche
veterinary=science veterinaria
economics=economia
internet=internet
weaponry=armi
gymnastics=ginnastica
insurance=assicurazioni
skiing=sci
clothing=abbigliamento
sociology=sociologia
education=istruzione
glass manufacturing=industria vetraria
broadcasting events=eventi televisivi
sects=sette
statistics=statistica
institutes=istituzioni
water polo=pallanuoto
tanning=conceria
hydrography=idrografia
didactics=didattica
craftwork=artigianato
law=diritto
music=musica
rocketry=missilistica
cosmography=cosmografia
polo=polo
judo=judo
game=gioco
memory=memoria
paleozoology=paleozoologia
shipping industry=industria nautica
cytology=citologia
perfumery=profumeria
circus=circo
design and engineering=motoristica
basketball=pallacanestro
cycling=ciclismo
exact science=scienze pure
folklore=folclore
aerospace engineering=ingegneria aerospaziale
poetry=poesia
mechanics=meccanica
meteorology=meteorologia
ceramic industry=industria ceramica
papyrology=papirologia
lacework=ricamo
Hinduism=induismo
archaeology=archeologia
volleyball=pallavolo
welfare=previdenza
geometry=geometria
sculpture=scultura
CAD (computer aided design)=cad
track racing=ciclismo su pista
silviculture=selvicoltura
television=televisione
fashion=moda
hardware=hardware
orthopedics=ortopedia
social service=servizi sociali
phytopathology=fitopatologia
phonetics=fonetica
billiards=biliardo
transports=trasporti
medieval history=storia medievale
squash=squash
telephony=telefonia
gallery=gallerie
marketing=marketing
lottery=lotterie
underwater fishing=pesca subacquea
atomic physics=fisica atomica
mining industry=industria estrattiva
finance=finanza
fishing=pesca
linguistics=linguistica
manufacturing=manifattura
technology=tecnologia
optics=ottica
orthodontics=odontoiatria
furniture=mobili
military=militare
social services=sicurezza sociale
pottery=ceramica
motorcycling=motociclismo
medicine=medicina
numismatics=numismatica
biology=biologia
electrotechnics=elettrotecnica
motorcycle industry=industria motociclistica
cross-country skiing=sci di fondo
cartography=cartografia
philosophy=filosofia
glassware=vetreria
softball=softball
printing=stampa
industrial design=industrial design
theology=teologia
artistic gymnastics=ginnastica artistica
theatre=teatro
artistic handicraft=artigianato artistico
bridge=bridge
phonology=fonologia
comics=fumetto
sport fishing=pesca sportiva
highway=strada
aeronautics=aeronautica
ethics=etica
chess=scacchi
aeronautics industry=industria aeronautica
stock exchange=borsa
modern history=storia moderna
handball=pallamano
bobsled=bob
revenue=fisco
antiques=antiquariato
typewriting=dattilografia
intranet=intranet
poker=poker
sport=sport
rugby=rugby
database=database
grammar=grammatica
business programs=programmi per ufficio
football=calcio
city planning=urbanistica
heavy athletics=atletica pesante
navy=marina militare
epigraphy=epigrafia
jeweller's art=oreficeria
energy=energia
microbiology=microbiologia
hydraulics=idraulica
e-mail=e-mail
pharmacology=farmacologia
coal mine=carbone
martial arts=arti marziali
topography=topografia
American football=football americano
philology=filologia
scuba diver=subacquea
jewellery=gioielleria
baseball=baseball
free climbing=free climbing
five-a-side football=calcetto
dietetics=dietetica
furniture industry=industria mobiliera
mineralogy=mineralogia
astronomy=astronomia
crime=criminalità
do it yourself=bricolage
boxing=boxe
crochet work=uncinetto
alternative medicine=medicina alternativa
graphic=computer grafica
rowing=canottaggio
advertising=pubblicità
windsurf=windsurf
kayak=kayak
graffito=graffiti
kitchen utensils=strumenti da cucina
golf=golf
video games=videogiochi
classical music=musica classica
occultism=occultismo
snowboard=snowboard
biophysics=biofisica
news=cronaca
Ministries=ministeri
apnea=apnea
gardening=giardinaggio
card games=giochi con le carte
newspapers=giornali
geophysics=geofisica
publishing=editoria
ballistics=balistica
astrophysics=astrofisica
telegraph=telegrafo
sled=slittino
mass communication=comunicazione
shorthand=stenografia
immunology=immunologia
metrics=metrica
parapsychology=parapsicologia
electricity=elettricità
tennis=tennis
bureaucratic terms=termini burocratici
collecting=collezionismo
clay-pigeon shooting=tiro al piattello
agriculture=agricoltura
tourism=turismo
scenography=scenografia
railway=ferrovia
liturgy=liturgia
ichthyology=ittiologia
commercial law=diritto commerciale
bowls=gioco delle bocce
hockey=hockey
embryology=embriologia
science fiction=fantascienza
acoustics=acustica
nets=reti
public relations=relazioni pubbliche
engineering=ingegneria
photography=fotografia
swimming=nuoto
marine biology=biologia marina
geography=geografia
accessory=accessori
fabric=tessuti
callisthenics=ginnastica ritmica
international law=diritto internazionale
stamp collecting=filatelia
genealogy=genealogia
school=scuola
zoology=zoologia
food industry=industria alimentare
electronics=elettronica
journalism=giornalismo
motor racing=automobilismo
downhill skiing=sci alpino
anatomy=anatomia
industry=industria
artillery=artiglieria
cardiology=cardiologia
singing=canto
railway industry=industria ferroviaria
biochemistry=biochimica
cultural terms=termini culturali
cricket=cricket
art=arte
musical instruments=strumenti
disks=dischi
knitting=maglia
car industry=industria automobilistica
athletics=atletica leggera
physics=fisica
archiving=archivistica
engraving=incisione
Parliament=parlamento
criminal law=diritto penale
study of coins=studio delle monete
telecommunications=telecomunicazioni
museums=musei
aerotechnics=aerotecnica
air force=aeronautica militare
sailing=vela
go kart=go kart
physiology=fisiologia
opera=opera
vine-growing=viticoltura
diplomacy=diplomazia
karate=karate
pedagogy=pedagogia
post=posta
automation=automazione
legislation=legislazione
skating=pattinaggio
iron and steel=industry siderurgia
genetics=genetica
lithography=litografia
electronic components=componenti elettronici
Christianity=cristianesimo
psychoanalysis=psicanalisi
tailoring=sartoria
radio=radio
robotics=robotica
fruit farming=frutticoltura
bowling=bowling
anthropology=antropologia
artistic photography=fotografia artistica
equitation=equitazione
show=spettacolo
technical terms=termini tecnici
computer science=informatica
ice hockey=hockey su ghiaccio
private law=diritto privato
public authority=amministrazione pubblica
geology=geologia
radiology=radiologia
police=polizia
archery=arco
horse racing=ippica
astrology=astrologia
surf=surf
pornography=pornografia
work=lavoro
motor vehicle=autoveicoli
mines=miniere
Islam=islam
sleddog=sleddog
literature=letteratura
social science=scienze sociali
heraldry=araldica
target-shooting=tiro a segno
inorganic chemistry=chimica inorganica
food=alimenti
company=impresa
hunting=caccia
mechanical drawing=tecnica
organic chemistry=chimica organica
diving=tuffi
operating systems=sistemi operativi
Bible=Bibbia
footwear=calzature
botany=botanica
catering=ristorazione
petrochemistry=petrolchimica
astronautics=astronautica
graphic's cards=schede grafiche
prehistory=preistoria
biotechnology=biotecnologie
civil law=diritto civile
ophthalmology=oculistica
breeding=allevamento
checkers=dama
board games=giochi da tavolo
cosmetics=cosmesi
printers=stampanti
ecology=ecologia
water skiing=sci nautico
dermatology=dermatologia
university=università
paleography=paleografia
processors=processori
multimedia=multimedia
cinema=cinema
toys=giocattoli
health board=sanità
entomology=entomologia